10 10
1 0
7 9
3 1 1 5 2 0 2 2 4 5
2 3 4 3 3 2 3 2 2 5
0 1 0 3 4 5 2 3 5 0
3 4 3 5 3 1 3 5 3 4
0 5 4 2 3 2 0 4 1 0
0 2 1 4 5 1 1 2 0 0
3 3 2 0 5 2 3 5 5 1
5 1 3 2 4 5 4 4 4 1
4 1 2 0 3 0 5 3 1 0
2 3 4 3 3 2 3 2 2 5